word	definition	pos
a	to	preposition
abierto	open	adjective
abril	April	noun
abrir	to open	verb
acabar	to finish	verb
académico	academic	adjective
acceder	to access	verb
acceso	access	noun
acción	action	noun
aceptar	to accept	verb
acompañar	to accompany	verb
actividad	activity	noun
activo	active	adjective
acto	act	noun
actual	current	adjective
actualmente	currently	adverb
acudir	to go	verb
acuerdo	agreement	noun
adecuado	appropriate	adjective
adelante	forward	adverb
además	also, besides	adverb
administración	administration	noun
administrativo	administrative	adjective
adquirir	to acquire	verb
adulto	adult	noun
advertir	to warn	verb
afectado	affected	adjective
afectar	to affect	verb
afirmar	to affirm	verb
agente	agent	noun
agosto	August	noun
agradecer	to thank	verb
agregar	to add	verb
agua	water	noun
ahí	there	adverb
ahora	now	adverb
aire	air	noun
al	to	preposition
alcalde	mayor	noun
alcanzar	reach	verb
algo	something	pronoun
alguien	someone	pronoun
alguno	some	determiner
alimento	food	noun
allá	there	adverb
allí	there	adverb
alrededor	around	adverb
alto	tall	adjective
alumno	pupil	noun
ambiente	environment	noun
ámbito	scope	noun
ambos	both	numeral
América	America	proper noun
amigo	friend	noun
amor	love	noun
amplio	large	adjective
añadir	to add	verb
análisis	analysis	noun
analizar	to analyze	verb
animal	animal	noun
año	year	noun
ante	before	preposition
anterior	previous	adjective
antes	before	adverb
Antonio	Anthony	proper noun
anunciar	to announce	verb
anuncio	advertisement	noun
aparecer	to appear	verb
apenas	barely	adverb
aplicación	application	noun
aplicar	to apply	verb
aportar	to contribute	verb
apoyar	to support	verb
apoyo	support	noun
aprender	to learn	verb
aprobar	to approve	verb
aprovechar	to take advantage of	verb
apuntar	to point	verb
aquel	that	determiner
aquí	here	adverb
área	area	noun
Argentina	Argentina	proper noun
arma	weapon	noun
artículo	article	noun
artista	artist	noun
asegurar	to secure	verb
así	thus	adverb
asimismo	likewise	adverb
asistir	to attend	verb
aspecto	appearance	noun
asumir	to assume	verb
asunto	affair	noun
ataque	attack	noun
atención	attention	noun
atender	to attend to	verb
aumentar	to increase	verb
aumento	increase	noun
aún	yet	adverb
aunque	though	conjunction
auto	car	noun
autor	author	noun
autoridad	authority	noun
avance	advance	noun
avanzar	to advance	verb
ayer	yesterday	adverb
ayuda	assistance	noun
ayudar	to help	verb
bajar	to go down	verb
bajo	low	preposition
barrio	neighborhood	noun
base	base	noun
básico	basic	adjective
bastante	quite	adverb
beneficio	benefit	noun
bien	well	adverb
blanco	white	adjective
brindar	to offer	verb
buen	good	adjective
bueno	good	adjective
buscar	to search	verb
búsqueda	search	noun
caber	to fit	verb
cabeza	head	noun
cabo	end, extremity	noun
cada	each	determiner
caer	to fall	verb
calidad	quality	noun
calle	street	noun
cambiar	to change	verb
cambio	change	noun
camino	road	noun
campaña	campaign	noun
campo	countryside	noun
candidato	candidate	noun
cantidad	amount	noun
capacidad	ability	noun
capaz	capable	adjective
capital	capital	noun
cara	face	noun
característica	characteristic	noun
cargo	position	noun
Carlos	Charles	proper noun
carrera	career	noun
casa	house	noun
casi	almost	adverb
caso	case	noun
categoría	category	noun
causa	cause	noun
causar	to cause	verb
celebrar	to celebrate	verb
central	central	adjective
centro	center	noun
cerca	close	adverb
cercano	near	adjective
cerrar	to close	verb
China	China	proper noun
ciencia	science	noun
científico	scientific	adjective
ciento	hundred	numeral
cierre	closing	noun
cierto	true, specific	determiner
cifra	number	noun
cinco	five	numeral
ciudad	city	noun
ciudadano	citizen	noun
civil	civil	adjective
claro	clear	adjective
clase	class	noun
clave	key	noun
cliente	client	noun
club	club	noun
colaboración	collaboration	noun
colectivo	collective	adjective
color	color	noun
comentar	to comment	verb
comentario	comment	noun
comenzar	to begin	verb
comercial	commercial	adjective
comercio	trade	noun
comida	food	noun
comisión	commission	noun
como	as	conjunction
cómo	how	pronoun
compañero	companion	noun
compañía	company	noun
compartir	to share	verb
competencia	competition	noun
completo	complete	adjective
compra	purchase	noun
comprar	to buy	verb
compromiso	commitment	noun
común	common	adjective
comunicación	communication	noun
comunicado	a statement, a press release	noun
comunidad	community	noun
con	with	preposition
concepto	concept	noun
concluir	to conclude	verb
condición	condition	noun
conferencia	conference	noun
confianza	confidence	noun
confirmar	to confirm	verb
conjunto	group, set	noun
conocer	to know	verb
conocido	known	adjective
conocimiento	knowledge	noun
consecuencia	consequence	noun
conseguir	to get	verb
considerar	to consider	verb
construcción	construction	noun
construir	to build	verb
consulta	consultation	noun
consumo	consumption	noun
contacto	contact	noun
contar	to count	verb
contener	to contain	verb
contenido	content	noun
contexto	context	noun
continuar	to continue	verb
contra	against	preposition
contrario	the contrary, the opposite	noun
contrato	contract	noun
contribuir	to contribute	verb
control	control	noun
convertir	to convert	verb
corazón	heart	noun
correo	mail	noun
corresponder	to correspond to	verb
correspondiente	corresponding	adjective
cosa	thing	noun
costo	cost	noun
creación	creation	noun
crear	to create	verb
crecer	to grow	verb
crecimiento	growth	noun
crédito	credit	noun
creer	to believe	verb
crisis	crisis	noun
Cruz	cross	proper noun
cual	which	pronoun
cuál	which	pronoun
cualquiera	any	determiner
cuando	when	conjunction
cuanto	how much	noun
cuarto	fourth	adjective
cuatro	four	numeral
cubrir	to cover	verb
cuenta	account	noun
cuerpo	body	noun
cuestión	question	noun
cuidado	care	noun
cultura	culture	noun
cultural	cultural	adjective
cumplir	to fulfill, to meet	verb
curso	course	noun
cuyo	whose	pronoun
daño	damage	noun
dar	to give	verb
dato	data	noun
de	of	preposition
deber	to have to	verb
debido	due	adjective
década	decade	noun
decidir	to decide	verb
decir	to tell	verb
decisión	decision	noun
declaración	statement	noun
declarar	to declare	verb
defender	to defend	verb
definir	to define	verb
dejar	to leave	verb
del	from	preposition
delito	crime	noun
demanda	demand	noun
demostrar	to show	verb
dentro	inside	adverb
dentro	complaint	noun
denunciar	to denounce	verb
departamento	department	noun
dependencia	dependence	noun
depender	to depend	verb
deportivo	sports	adjective
derecho	law	noun
desarrollar	to develop	verb
desarrollo	development	noun
descubrir	to discover	verb
desde	since	preposition
desear	to want	verb
después	afterwards	adverb
destacar	to highlight, to emphasize	verb
destino	destiny	noun
detallar	to detail	verb
detalle	detail	noun
detectar	to detect	verb
detener	to stop	verb
determinar	to determine	verb
día	day	noun
diario	daily	adjective
dicho	said	adjective
diciembre	December	noun
diez	ten	numeral
diferencia	difference	noun
diferente	different	adjective
difícil	hard	adjective
digital	digital	adjective
dinero	money	noun
Dios	God	proper noun
diputado	deputy	noun
dirección	address	noun
directo	straight	adjective
director	director	noun
dirigido	directed	adjective
dirigir	to direct	verb
diseño	design	noun
disfrutar	to enjoy	verb
disponer	to prepare	verb
disponible	available	adjective
disposición	tendency, layout	noun
dispositivo	device	noun
distancia	distance	noun
distinto	different	determiner
diverso	miscellaneous	determiner
docente	teacher, lecturer	noun
documento	document	noun
dólares	dollars	noun
domicilio	address, residence	noun
domingo	Sunday	noun
donde	where	pronoun
dónde	where	pronoun
dos	two	numeral
duda	doubt	noun
durante	during	preposition
e	and	conjunction
economía	economy	noun
económico	economic	adjective
edad	age	noun
edición	edition	noun
edificio	building	noun
educación	education	noun
educativo	educational	adjective
efectivo	effective	adjective
efecto	effect	noun
ejemplo	example	noun
ejercicio	exercise	noun
el	the	determiner
él	he	pronoun
elección	choice	noun
electoral	electoral	adjective
eléctrico	electric	adjective
electrónico	electronic	adjective
elegir	to choose	verb
elemento	element	noun
embargo	embargo	noun
emergencia	emergency	noun
emitir	to emit	verb
empezar	to start	verb
empleado	employee	noun
empleo	job	noun
empresa	company	noun
en	in	preposition
encontrar	to find	verb
encuentro	meeting	noun
energía	energy	noun
enero	January	noun
enfrentar	to confront	verb
entender	to understand	verb
entidad	entity	noun
entonces	then	adverb
entrada	entrance	noun
entrar	to get in	verb
entre	between	preposition
entrega	delivery	noun
entregar	to deliver	verb
entrevista	interview	noun
enviar	to send	verb
equipo	equipment	noun
escenario	stage	noun
escolar	school	adjective
escribir	to write	verb
escrito	written	adjective
escuchar	to listen	verb
escuela	school	noun
ese	that	determiner
esfuerzo	effort	noun
espacio	space	noun
España	Spain	proper noun
español	Spanish	adjective
especial	special	adjective
especialista	specialist	noun
especialmente	especially	adverb
especie	species	noun
específico	specific	adjective
esperar	to expect	verb
establecer	to establish	verb
establecido	established	adjective
estado	state	noun
estadounidense	American	adjective
estar	to be	verb
estatal	state	adjective
este	this	determiner
estrategia	strategy	noun
estructura	structure	noun
estudiante	student	noun
estudiar	to study	verb
estudio	study	noun
etapa	stage	noun
Europa	Europe	proper noun
euros	euros	noun
evaluación	evaluation	noun
evento	event	noun
evitar	to avoid	verb
ex	former	adjective
examen	examination	noun
excelente	excellent	adjective
exigir	to demand	verb
existir	to exist	verb
éxito	success	noun
experiencia	experience	noun
experto	expert	noun
explicar	to explain	verb
expresar	to express	verb
extranjero	foreign	adjective
fácil	easy	adjective
factor	factor	noun
fallecido	deceased	adjective
falta	lack	noun
faltar	to lack	verb
familia	family	noun
familiar	family	adjective
fase	phase	noun
favor	please	noun
febrero	February	noun
fecha	date	noun
federal	federal	adjective
fiesta	party	noun
fin	end	noun
final	final	noun
finalmente	finally	adverb
financiero	financial	adjective
firma	signature	noun
fiscal	fiscal	adjective
físico	physical	adjective
fondo	background	noun
forma	form	noun
formación	training	noun
formar	to form	verb
formato	format	noun
fortalecer	to strengthen	verb
foto	photo	noun
Francisco	Francis	proper noun
frente	front	noun
fuente	source	noun
fuera	outside	adverb
fuerte	strong	adjective
fuerza	strength	noun
función	function	noun
funcionar	to function	verb
funcionario	an official	noun
fundamental	fundamental	adjective
futuro	future	noun
ganar	to gain	verb
garantizar	to guarantee	verb
García	Garcia	proper noun
gasto	expenditure	noun
generación	generation	noun
general	general	adjective
generar	to generate	verb
género	a kind, a genre	noun
gente	people	noun
gestión	management	noun
global	global	adjective
gobernador	governor	noun
gobierno	government	noun
González	Gonzalez	proper noun
gracias	thanks	noun
grado	degree	noun
gran	great	adjective
grande	great	adjective
grave	serious	adjective
grupo	group	noun
Guadalajara	Guadalajara	proper noun
gustar	to like	verb
haber	to have	verb
habitante	inhabitant	noun
hablar	to speak	verb
hacer	to do	verb
hacia	towards	preposition
hasta	until	preposition
hecho	fact	noun
herramienta	a tool	noun
hijo	son	noun
historia	history	noun
histórico	historical	adjective
hogar	home	noun
hombre	man	noun
hora	hour	noun
horario	schedule	noun
hospital	hospital	noun
hotel	hotel	noun
hoy	today	adverb
humano	human	adjective
idea	idea	noun
identificar	to identify	verb
igual	same	adjective
imagen	image	noun
impacto	impact	noun
implicar	to imply	verb
importancia	importance	noun
importante	important	adjective
impuesto	tax	noun
impulsar	to boost, to propel	verb
incluir	to include	verb
incluso	even	adverb
incrementar	to increase	verb
indicar	to indicate	verb
industria	industry	noun
industrial	industrial	adjective
información	information	noun
informar	inform	verb
informe	report	noun
ingresar	to enter, to join	verb
ingreso	entrance	noun
iniciar	to start, to begin	verb
iniciativa	initiative	noun
inicio	start	noun
inmediato	immediate	adjective
instalación	installation	noun
institución	institution	noun
integrante	member	noun
integrar	to integrate	verb
intentar	to attempt	verb
interés	interest	noun
interior	the inside, the interior	noun
internacional	international	adjective
interno	internal	adjective
intervención	intervention	noun
inversión	investment	noun
investigación	research	noun
investigador	investigator	noun
invitar	to invite	verb
ir	to go	verb
jefe	chief	noun
Jesús	Jesus	proper noun
Jorge	George	proper noun
jornada	working day	noun
José	Joseph	proper noun
joven	youth, young person	noun
Juan	John	proper noun
juego	game	noun
jueves	Thursday	noun
jugador	player	noun
jugar	to play	verb
julio	July	noun
junio	June	noun
junto	together	adjective
jurídico	legal	adjective
justicia	justice	noun
kilómetro	kilometer	noun
labor	work	noun
laboral	labor	adjective
lado	side	noun
lanzar	to throw	verb
largo	long	adjective
lectura	reading	noun
leer	to read	verb
legal	legal	adjective
ley	law	noun
libertad	freedom	noun
libre	free	adjective
libro	book	noun
líder	leader	noun
línea	line	noun
lista	list	noun
llamado	called	adjective
llamar	to call	verb
llegar	to get	verb
llevar	to carry	verb
local	local	adjective
localidad	locality	noun
lograr	to achieve	verb
López	Lopez	proper noun
lucha	struggle, fight	noun
luego	then, later	adverb
lugar	place	noun
Luis	louis	proper noun
lunes	Monday	noun
luz	light	noun
madre	mother	noun
Madrid	Madrid	proper noun
maestro	teacher	noun
mal	badly	adverb
mañana	tomorrow	noun
manejo	driving	noun
manera	way	noun
manifestar	to manifest	verb
mano	hand	noun
mantener	keep	verb
Manuel	Manual	proper noun
marca	brand	noun
marcar	to mark	verb
marcha	march	noun
marco	framework	noun
María	Mary	proper noun
martes	Tuesday	noun
Martínez	Martinez	proper noun
marzo	March	noun
mas	but	adverb
más	more	adverb
materia	matter	noun
material	material	noun
máximo	maximum	adjective
mayo	May	noun
mayor	older	adjective
mayoría	majority	noun
mediante	through	preposition
medida	measure	noun
medio	medium	noun
mejor	better	adjective
mejorar	to improve	verb
mencionar	to mention	verb
menor	minor	adjective
menos	less	adverb
mensaje	message	noun
mercado	market	noun
mes	month	noun
mesa	table	noun
metro	meter	noun
mexicano	Mexican	adjective
México	Mexico	proper noun
mi	my	determiner
miembro	member	noun
mientras	while	conjunction
miércoles	Wednesday	noun
Miguel	Michael	proper noun
mil	thousand	numeral
militar	military	adjective
millón	million	noun
mínimo	minimum	adjective
ministro	minister	noun
minuto	minute	noun
mismo	same	determiner
mitad	half	noun
modelo	model	noun
modo	mode, manner, way	noun
momento	moment	noun
morir	to die	verb
mostrar	to show	verb
motivo	reason, cause	noun
movimiento	movement	noun
mucho	much	adverb
muerte	death	noun
muerto	dead	noun
muestra	sample	noun
mujer	woman	noun
mundial	global, worldwide	adjective
mundo	world	noun
municipal	municipal	adjective
municipio	municipality	noun
música	music	noun
nacional	national	adjective
nada	nothing	pronoun
nadie	no one	pronoun
natural	natural	adjective
necesario	necessary	adjective
necesidad	need	noun
necesitar	to need	verb
negocio	business	noun
ni	neither	conjunction
niña	girl	noun
ninguno	none	determiner
niño	child	noun
nivel	level	noun
no	no	adverb
noche	night	noun
nombre	name	noun
norma	rule	noun
noticia	news, message	noun
noviembre	November	noun
nuestro	our	determiner
Nueva	New	proper noun
nuevo	new	adjective
número	number	noun
nunca	never	adverb
o	or	conjunction
objetivo	objective	noun
objeto	object	noun
obra	work	noun
observar	to observe	verb
obstante	however	noun
obtener	to obtain	verb
ocasión	occasion	noun
ocho	eight	numeral
octubre	October	noun
ocupar	to occupy	verb
ocurrir	to occur	verb
oferta	offer	noun
oficial	official	adjective
oficina	office	noun
ofrecer	to offer	verb
opción	option	noun
operación	operation	noun
operativo	operation	noun
opinión	opinion	noun
oportunidad	opportunity	noun
orden	order	noun
organismo	organism	noun
organización	organization	noun
organizar	to organize	verb
origen	origin	noun
original	original	adjective
otorgar	to grant	verb
otro	other	determiner
paciente	patient	noun
padre	father	noun
pagar	to pay	verb
página	page	noun
pago	payment	noun
país	country	noun
palabra	word	noun
papel	paper	noun
para	for	preposition
parecer	to seem	verb
pareja	partner	noun
parte	part	noun
participación	participation	noun
participar	to take part	verb
particular	particular	adjective
partido	match, party	noun
partir	to depart	verb
pasado	past	adjective
pasar	pass	verb
paso	step	noun
pedir	to request	verb
Pedro	Peter	proper noun
película	movie	noun
pensar	to think	verb
peor	worse	adjective
pequeño	little	adjective
perder	to lose	verb
periodista	journalist	noun
periodo	period	noun
permanecer	to stay	verb
permitir	to allow	verb
pero	but	conjunction
persona	person	noun
personaje	a character, a person	noun
personal	personal	adjective
pesar	grief	noun
peso	weight	noun
plan	plan	noun
planta	plant	noun
plantear	to pose	verb
plataforma	platform	noun
plaza	town square	noun
plazo	deadline	noun
pleno	full	adjective
población	population	noun
poco	little	adverb
poder	to be able	verb
policía	police	noun
política	politics	noun
político	political	adjective
poner	to put	verb
popular	popular	adjective
por	for, by	preposition
porque	because	conjunction
posibilidad	possibility	noun
posible	possible	adjective
posición	position	noun
positivo	positive	adjective
práctica	practice	noun
precio	price	noun
precisar	to specify	verb
pregunta	question	noun
preguntar	to ask	verb
premio	prize	noun
prensa	press	noun
preparar	to prepare	verb
presencia	presence	noun
presentación	presentation	noun
presentar	to introduce	verb
presente	present	adjective
presidente	president	noun
presupuesto	budget	noun
pretender	to intend	verb
previo	previous	adjective
previsto	planned, predicted	adjective
primero	first	adjective
principal	main	adjective
principio	beginning	noun
privado	private	adjective
problema	issue	noun
procedimiento	procedure	noun
proceso	process	noun
producción	production	noun
producir	to produce	verb
producto	product	noun
profesional	professional	adjective
profesor	professor	noun
programa	program	noun
promedio	average	noun
promover	to promote	verb
pronto	soon	adverb
propiedad	property	noun
propio	own	determiner
proponer	to propose	verb
proporcionar	to provide	verb
propuesta	proposal	noun
protección	protection	noun
proteger	to protect	verb
protocolo	protocol	noun
provincia	province	noun
provocar	to provoke, to cause	verb
próximo	next	adjective
proyecto	project	noun
prueba	test	noun
publicación	publication	noun
publicado	published	adjective
publicar	publish	verb
publicidad	advertisement	noun
público	public	adjective
Puebla	Puebla	proper noun
pueblo	village	noun
puerta	gate	noun
pues	since, thus	conjunction
puesto	job, stand	noun
punto	point	noun
que	that	pronoun
qué	what	pronoun
quedar	to stay	verb
querer	to want	verb
quien	who	pronoun
quién	who	pronoun
rápido	quick	adjective
razón	reason	noun
real	royal, real	adjective
realidad	reality	noun
realizado	done, realized	adjective
realizar	to realize	verb
realmente	really	adverb
recibir	to receive	verb
reciente	recent	adjective
recomendar	to recommend	verb
reconocer	to recognize	verb
reconocimiento	recognition	noun
recordar	to remember	verb
recuperar	to recover	verb
recurso	resource	noun
red	net	noun
reducir	to reduce	verb
referir	to report	verb
reforma	reform	noun
región	region	noun
regional	regional	adjective
registrar	to register	verb
registro	registration	noun
regresar	to return	verb
relación	relationship	noun
relacionado	related	adjective
reportar	to report	verb
representante	representative	noun
representar	to represent	verb
requerir	to require	verb
requisito	requirement	noun
resolución	resolution	noun
resolver	to solve	verb
respecto	regard	noun
respetar	to respect	verb
responder	to answer	verb
responsabilidad	responsibility	noun
responsable	responsible	noun
respuesta	response	noun
resto	rest	noun
resultado	result	noun
resultar	to result	verb
reto	challenge	noun
reunión	meeting	noun
revelar	to reveal	verb
revisar	to check	verb
riesgo	risk	noun
Rodríguez	Rodriguez	proper noun
sábado	Saturday	noun
saber	to know	verb
sacar	to take out, to withdraw	verb
sala	room	noun
salida	exit	noun
salir	to leave	verb
salud	health	noun
Sánchez	Sanchez	proper noun
sanitario	sanitary	adjective
secretario	secretary	noun
sector	sector	noun
seguir	to continue	verb
según	according to	preposition
segundo	second	adjective
seguridad	security	noun
seguro	safe	adjective
seis	six	numeral
semana	week	noun
señalar	to point out	verb
sentido	sense	noun
sentir	to feel	verb
septiembre	September	noun
ser	to be	verb
serie	series	noun
servicio	service	noun
servir	to serve	verb
sesión	session	noun
si	if	conjunction
sí	yes	interjection
siempre	always	adverb
siete	seven	numeral
siglo	century	noun
significar	to mean	verb
siguiente	next	adjective
similar	similar	adjective
sin	without	preposition
sino	but	conjunction
sistema	system	noun
sitio	place	noun
situación	situation	noun
sobre	on	preposition
social	social	adjective
sociedad	society	noun
solicitar	request	verb
solicitud	request	noun
solo	only	adjective
sólo	only	adverb
solución	solution	noun
sostener	to hold	verb
su	your, his, hers, its, their	determiner
subir	to raise, to go up	verb
suceder	to happen	verb
suficiente	enough	adjective
sufrir	to suffer	verb
sujeto	subject	noun
sumar	to add	verb
superar	to overcome	verb
superior	higher	adjective
suponer	to suppose	verb
supuesto	assumption	noun
tal	such	noun
también	also, too	adverb
tampoco	neither	adverb
tanto	so much	adverb
tarde	afternoon	noun
tarea	task	noun
tasa	rate	noun
técnico	technical	adjective
tecnología	technology	noun
tecnológico	technological	adjective
teléfono	telephone	noun
tema	theme	noun
temporada	season	noun
tener	to have	verb
tercero	third	adjective
terminar	to end up	verb
término	end	noun
terreno	land	noun
territorio	territory	noun
texto	text	noun
tiempo	time	noun
tienda	store	noun
tierra	land	noun
tipo	type	noun
titular	headline	noun
título	title	noun
tocar	to play	verb
todavía	yet	adverb
todo	all	determiner
tomar	to take	verb
total	total	adjective
trabajador	worker	noun
trabajar	to work	verb
trabajo	work	noun
traer	to bring	verb
trámite	procedure	noun
transporte	transportation	noun
tras	after	preposition
trasladar	to move	verb
tratamiento	treatment	noun
tratar	to treat	verb
través	through	noun
tres	three	numeral
tu	your	determiner
tú	you	pronoun
ubicado	located	adjective
último	latest	adjective
único	unique	adjective
unidad	a unit	noun
universidad	college	noun
universitario	university	adjective
uno	one	determiner
usar	to use	verb
uso	use	noun
usted	you	pronoun
usuario	user	noun
utilizar	to use	verb
valor	value	noun
varios	several	determiner
vecino	neighbour	noun
vehículo	vehicle	noun
vender	to sell	verb
Venezuela	Venezuela	proper noun
venir	to come	verb
venta	sale	noun
ver	to see	verb
verdad	truth	noun
versión	version	noun
vez	time	noun
vía	via	noun
viajar	to travel	verb
viaje	trip	noun
víctima	victim	noun
vida	life	noun
video	video	noun
viernes	Friday	noun
violencia	violence	noun
virtual	virtual	adjective
visita	visit	noun
visitar	to visit	verb
vista	a sight, a view	noun
vivienda	housing	noun
vivir	to live	verb
volver	to return	verb
voto	vote	noun
voz	voice	noun
web	web	noun
y	and	conjunction
ya	now	adverb
yo	I	pronoun
zona	zone	noun
hace	ago	adverb
